lv6_S,,,,,,,,,,,
no_,no_,no_,op_,,,,,,,,
ll_,___,___,___,___,___,___,___,___,___,___,___
___,___,___,___,___,___,___,___,___,ll_,___,___
___,Wi_,___,OW_,___,___,___,___,___,___,___,___
___,___,___,___,___,___,bj_,___,ll_,___,___,___
___,___,___,___,___,___,___,___,bu_,___,OW_,___
___,Wi_,___,___,___,___,___,___,___,___,___,___
___,___,___,___,___,___,___,___,___,___,___,___