lv6_S,,,,,,,,,,,
cl_,no_,no_,op_,,,,,,,,
___,___,___,___,___,___,___,___,___,___,___,___
___,___,bl_,___,___,___,___,ll_,___,bl_,___,___
___,___,___,___,___,___,___,Wi_,___,___,___,___
___,___,OW_,___,___,Wi_,___,___,___,OW_,___,___
___,___,___,___,___,___,___,___,ll_,___,___,___
___,___,bl_,bu_,___,___,___,___,___,bl_,ll_,___
___,___,___,___,___,___,___,___,___,___,___,___