lv6_S,,,,,,,,,,,
cl_,no_,cl_,no_,,,,,,,,
___,___,___,ll_,___,___,___,___,___,___,___,___
___,___,___,___,___,___,___,___,Wi_,___,ll_,___
___,___,___,___,___,___,ll_,___,___,___,___,___
___,___,___,___,bj_,___,___,bl_,___,___,___,___
___,___,___,___,___,___,___,___,Wi_,___,___,___
___,___,___,___,___,___,___,___,___,___,___,___
___,___,OW_,___,___,___,___,___,___,OW_,___,___