lv6_S,,,,,,,,,,,
op_,no_,op_,no_,,,,,,,,
___,___,___,___,lz_,___,___,___,lz_,___,___,___
___,___,___,___,___,___,___,___,___,___,___,___
___,___,bl_,bl_,lz_,___,___,lz_,bl_,bl_,___,___
___,___,bl_,bl_,___,___,cs_,___,bl_,bl_,___,___
___,___,bl_,bl_,___,___,___,___,bl_,bl_,___,___
___,___,___,___,lz_,___,___,___,___,___,___,___
___,___,___,___,___,___,___,___,___,___,___,___