lv6_S,,,,,,,,,,,
no_,cl_,cl_,no_,,,,,,,,
bl_,bl_,bl_,bl_,bl_,___,___,bl_,bl_,bl_,bl_,bl_
bl_,bl_,bl_,bl_,___,___,___,___,bl_,bl_,bl_,bl_
bl_,___,___,___,___,___,___,___,___,___,bl_,bl_
___,___,___,___,___,___,___,___,___,___,___,___
___,___,___,___,___,___,___,___,___,___,___,___
___,___,bl_,___,___,___,___,___,___,bl_,___,___
___,___,___,___,___,___,___,___,___,___,___,___