lv6_S,,,,,,,,,,,
op_,op_,no_,no_,,,,,,,,
___,___,___,___,___,___,___,OW_,___,___,___,___
___,___,___,___,___,___,___,___,___,___,___,___
wa_,wa_,wa_,wa_,wa_,wa_,wa_,wa_,wa_,wa_,wa_,wa_
___,___,OW_,___,___,___,___,ky_,___,___,___,___
___,___,___,___,___,___,OW_,___,___,OW_,___,___
___,OW_,___,___,___,___,___,___,___,OW_,___,___
___,___,OW_,___,___,___,___,___,___,___,___,___