lv6_S,,,,,,,,,,,
op_,lk_,no_,no_,,,,,,,,
___,___,___,___,___,___,___,___,___,___,___,___
___,bl_,bl_,___,___,___,___,___,___,bl_,bl_,___
___,___,___,___,___,___,___,___,___,___,___,___
___,___,OW_,___,___,bl_,bl_,OW_,OW_,OW_,OW_,___
___,___,___,___,___,___,___,___,___,___,___,___
___,bl_,bl_,___,___,___,___,___,___,bl_,bl_,___
___,___,___,___,___,___,___,___,___,___,___,___