lv6_S,,,,,,,,,,,
cl_,no_,no_,no_,,,,,,,,
wa_,wa_,wa_,wa_,wa_,___,___,wa_,wa_,wa_,wa_,wa_
wa_,___,___,___,wa_,___,___,___,___,wa_,___,wa_
wa_,___,wa_,___,wa_,___,wa_,wa_,__,wa_,___,wa_
___,OW_,wa_,OW_,wa_,___,___,wa_,Wi_,wa_,Wi_,___
wa_,___,wa_,___,wa_,wa_,bb_,wa_,___,wa_,___,wa_
wa_,___,wa_,___,___,___,___,wa_,___,___,Wi_,wa_
wa_,wa_,wa_,wa_,wa_,___,___,wa_,wa_,wa_,wa_,wa_