lv6_S,,,,,,,,,,,
lk_,op_,op_,no_,,,,,,,,
sp_,___,___,___,___,___,___,___,Wi_,___,___,sp_
___,___,___,___,___,___,___,___,___,___,___,___
___,___,___,___,___,___,___,___,___,___,___,___
___,___,Wi_,___,___,___,OW_,___,OW_,___,___,___
___,___,___,___,___,___,___,___,___,___,___,___
___,___,___,___,___,___,___,___,___,___,___,___
sp_,___,___,___,___,___,___,___,___,___,___,sp_