lv6_S,,,,,,,,,,,
cl_,no_,op_,no_,,,,,,,,
st_,___,___,___,___,ks_,___,___,___,___,___,so_
___,___,___,___,___,___,___,___,___,___,___,___
___,___,ks_,___,___,ky_,___,___,___,___,ks_,___
___,___,ks_,___,___,___,ks_,___,___,ks_,___,___
___,___,___,___,___,___,___,___,ks_,___,___,___
___,___,___,___,___,___,___,ks_,___,___,___,___
st_,___,___,___,___,ks_,___,___,___,___,___,so_