lv6_S,,,,,,,,,,,
op_,no_,op_,no_,,,,,,,,
sp_,___,___,___,___,___,___,___,___,___,___,sp_
___,___,___,___,___,___,___,___,___,___,___,___
___,___,bl_,___,___,___,___,___,___,bl_,___,___
___,bl_,sp_,___,___,___,___,___,___,sp_,bl_,___
___,___,bl_,___,___,___,___,___,___,bl_,___,___
___,___,___,___,___,___,___,___,___,___,___,___
sp_,___,___,___,___,___,___,___,___,___,___,sp_