lv6_S,,,,,,,,,,,
no_,bb_,no_,no_,,,,,,,,
___,___,___,___,___,___,___,___,wa_,___,___,___
___,___,___,___,lz_,___,ll_,___,wa_,___,___,___
___,___,___,___,___,___,___,___,wa_,bu_,___,___
___,___,___,___,___,___,___,mp_,wa_,___,___,lz_
___,___,___,___,___,___,___,___,wa_,___,___,___
___,___,___,___,___,___,___,___,wa_,bu_,___,___
___,___,ll_,___,___,___,___,___,wa_,___,___,___