lv6_S,,,,,,,,,,,
cl_,no_,op_,no_,,,,,,,,
___,___,___,___,___,___,___,___,___,___,___,___
___,___,___,___,___,___,___,___,___,___,___,___
___,___,___,___,___,GO_,___,___,___,___,___,___
___,bl_,___,___,___,___,hc_,___,___,___,bl_,___
___,___,___,___,___,___,___,___,___,___,___,___
___,___,___,bl_,___,___,___,___,bl_,___,___,___
st_,___,___,___,___,___,___,___,___,___,___,so_