lv6_S,,,,,,,,,,,
op_,no_,no_,op_,,,,,,,,
___,___,___,___,___,___,___,___,wa_,___,___,___
___,___,Vi_,___,___,___,___,___,wa_,___,___,___
___,bu_,___,___,Vi_,___,___,___,wa_,___,___,___
___,___,___,___,___,___,___,___,wa_,___,___,___
___,___,___,___,___,___,ky_,___,wa_,___,___,___
___,___,___,___,___,___,___,Vi_,wa_,___,___,___
___,___,___,___,___,___,___,bu_,wa_,___,___,___