lv6_S,,,,,,,,,,,
op_,no_,no_,op_,,,,,,,,
___,___,___,___,___,___,___,___,bl_,bl_,bl_,bl_
___,___,___,___,___,bu_,___,___,bl_,bl_,bl_,bl_
___,___,ll_,___,___,___,___,___,___,bl_,bl_,bl_
___,___,___,___,___,___,___,___,___,___,___,___
___,___,___,___,___,___,___,ll_,lz_,bl_,bl_,bl_
___,___,lz_,___,bu_,___,___,___,bl_,bl_,bl_,bl_
___,___,___,___,___,___,___,___,bl_,bl_,bl_,bl_