lv6_S,,,,,,,,,,,
lk_,no_,no_,op_,,,,,,,,
___,___,___,___,___,___,___,___,___,___,___,___
___,___,b2_,___,___,OW_,___,___,___,b2_,___,___
___,___,___,___,___,___,___,___,___,___,___,___
___,___,___,___,___,___,ky_,___,OW_,OW_,OW_,___
___,___,___,___,___,___,___,___,___,___,___,___
OW_,___,b2_,___,___,___,___,___,___,b2_,___,___
___,___,___,___,___,___,___,___,___,___,___,___