lv6_S,,,,,,,,,,,
no_,bb_,no_,bb_,,,,,,,,
___,___,___,___,___,___,___,___,___,___,___,sr_
___,___,___,Wi_,___,___,___,___,___,___,___,___
OW_,___,___,___,___,___,___,___,___,___,___,___
___,___,___,___,bj_,___,___,bl_,___,___,___,___
___,___,___,___,Wi_,___,___,___,___,___,___,___
___,___,___,___,___,___,___,___,___,___,___,___
___,___,___,Wi_,___,___,___,___,___,___,___,OW_