lv6_S,,,,,,,,,,,
op_,bb_,cl_,no_,,,,,,,,
___,___,Wi_,___,___,___,___,___,Wi_,___,___,fr_
___,bl_,___,bl_,___,bl_,bl_,___,bl_,___,bl_,___
___,___,___,___,___,___,___,Wi_,___,___,___,___
___,bl_,___,bl_,OW_,bl_,bl_,___,bl_,___,bl_,___
___,___,___,___,___,___,___,___,___,___,___,___
___,bl_,___,bl_,___,bl_,bl_,___,bl_,___,bl_,___
___,___,___,___,___,___,___,___,___,OW_,___,___