lv6_S,,,,,,,,,,,
cl_,cl_,no_,no_,,,,,,,,
___,___,___,___,___,___,___,___,wa_,___,___,___
___,___,___,Vi_,___,___,___,___,wa_,___,___,___
___,___,___,___,___,___,___,___,wa_,___,___,___
___,___,___,___,___,___,___,Vi_,wa_,___,___,___
___,___,___,___,___,___,___,___,wa_,___,___,___
___,___,___,___,Vi_,Vi_,___,Vi_,wa_,___,___,___
___,___,___,___,___,___,___,___,wa_,___,___,___