lv6_S,,,,,,,,,,,
no_,no_,op_,bb_,,,,,,,,
___,___,___,Wi_,___,___,___,___,___,___,___,___
___,wa_,wa_,wa_,wa_,wa_,wa_,wa_,wa_,wa_,wa_,___
Wi_,wa_,___,___,___,___,___,___,OW_,___,wa_,___
___,wa_,___,___,___,___,ky_,___,___,___,wa_,___
___,wa_,___,OW_,___,___,___,___,___,___,wa_,___
Wi_,wa_,wa_,wa_,wa_,wa_,wa_,wa_,wa_,wa_,wa_,___
___,___,___,___,___,___,___,___,___,___,___,___