lv6_S,,,,,,,,,,,
no_,bb_,cl_,bb_,,,,,,,,
___,___,___,___,___,___,___,___,___,___,___,___
bu_,___,___,___,___,___,___,___,___,___,___,___
___,___,___,zl_,___,ll_,___,___,___,___,___,___
___,___,___,___,bl_,___,___,bl_,___,___,___,___
___,___,___,___,___,ll_,___,___,___,___,___,___
___,bu_,___,zl_,___,___,___,___,___,___,___,___
___,___,___,___,___,___,___,___,___,___,___,___