lv3_S,,,,,,,,,,,
op_,lk_,no_,bb_,,,,,,,,
___,___,___,___,___,___,___,___,___,___,___,___
___,bl_,bl_,___,___,___,rn_,___,rn_,bl_,bl_,___
___,___,___,___,___,___,___,___,___,___,___,___
___,___,___,___,___,bl_,bl_,___,___,___,___,___
___,___,___,___,___,rn_,___,___,___,___,___,___
___,bl_,bl_,___,___,___,___,___,___,bl_,bl_,___
___,___,___,___,___,___,___,___,___,___,___,___