lv3_S,,,,,,,,,,,
no_,bb_,op_,lk_,,,,,,,,
sp_,___,___,___,___,___,zb_,___,___,___,___,sp_
___,___,___,___,___,___,___,___,___,___,___,___
___,___,___,___,___,___,___,___,___,___,___,___
___,___,___,___,___,___,___,___,___,___,___,___
___,___,___,___,___,___,mp_,___,___,___,___,___
___,___,___,___,___,___,___,zb_,___,___,___,___
sp_,___,___,___,___,___,___,___,___,___,___,sp_