lv3_S,,,,,,,,,,,
op_,no_,op_,no_,,,,,,,,
___,___,bl_,___,zb_,___,___,___,___,___,___,bl_
___,bl_,___,___,___,bl_,___,___,zb_,___,bl_,___
___,___,___,___,bl_,___,zb_,___,___,bl_,___,___
___,___,___,bl_,___,zb_,ky_,___,bl_,___,___,___
___,___,bl_,___,___,___,___,bl_,___,___,___,___
___,bl_,___,zb_,___,___,bl_,___,___,___,bl_,___
bl_,___,___,___,___,___,___,___,___,bl_,___,___