lv3_S,,,,,,,,,,,
lk_,lk_,op_,lk_,,,,,,,,
___,___,___,___,___,___,___,___,zb_,___,___,___
___,bl_,bl_,bl_,bl_,bl_,bl_,bl_,bl_,bl_,bl_,___
___,___,___,___,___,zb_,___,___,___,___,bl_,___
___,___,___,___,___,ky_,___,zb_,___,___,bl_,___
___,___,___,___,___,___,___,___,___,___,bl_,___
___,bl_,bl_,bl_,bl_,bl_,bl_,bl_,bl_,bl_,bl_,___
___,___,___,___,___,___,___,___,___,___,___,___