lv3_S,,,,,,,,,,,
no_,cl_,no_,no_,,,,,,,,
___,ks_,___,___,___,___,___,ks_,___,___,___,___
___,___,___,___,___,___,___,rn_,___,___,___,___
___,___,bl_,bl_,rn_,___,___,___,bl_,bl_,___,___
___,ks_,bl_,bl_,ks_,___,ky_,___,bl_,bl_,___,___
___,rn_,bl_,bl_,rn_,___,___,___,bl_,bl_,___,___
___,___,___,___,ks_,___,___,rn_,ks_,___,___,___
___,ks_,___,___,___,___,___,___,___,___,___,___