lv3_S,,,,,,,,,,,
lk_,no_,no_,lk_,,,,,,,,
fr_,___,___,___,___,___,___,___,___,___,___,___
___,___,___,___,___,___,___,___,___,ks_,___,___
___,___,___,___,___,bl_,bl_,___,___,___,___,___
___,___,___,___,___,bl_,bl_,___,bu_,___,___,___
___,___,___,___,___,bl_,bl_,ks_,___,___,___,bu_
___,___,ks_,___,___,___,___,zb_,___,bu_,zb_,___
___,___,___,___,___,___,___,___,___,___,___,___