lv3_S,,,,,,,,,,,
op_,op_,no_,no_,,,,,,,,
___,___,___,___,___,___,___,___,___,___,___,___
zb_,___,bl_,___,___,___,___,___,___,bl_,___,___
zb_,___,___,___,zb_,___,___,___,___,___,___,___
___,___,___,___,___,___,ky_,___,___,___,___,___
___,zb_,___,___,zb_,___,___,___,___,___,___,___
___,___,bl_,___,___,___,___,___,zb_,bl_,___,___
___,___,___,___,___,___,___,___,___,___,___,___