lv3_S,,,,,,,,,,,
no_,lk_,op_,op_,,,,,,,,
___,___,___,ks_,___,___,___,___,___,___,___,___
___,___,___,___,___,___,___,___,___,___,ks_,___
bl_,bl_,bl_,bl_,bl_,bl_,bl_,bl_,bl_,bl_,bl_,bl_
___,___,___,___,___,bb_,___,___,___,___,___,ks_
bl_,bl_,bl_,bl_,bl_,bl_,bl_,bl_,bl_,bl_,bl_,bl_
___,___,___,___,___,___,___,___,___,___,ks_,___
___,___,___,___,ks_,___,___,___,___,___,___,___