lv3_S,,,,,,,,,,,
op_,bb_,op_,op_,,,,,,,,
___,___,___,___,___,___,___,___,rn_,___,___,___
___,___,___,___,___,___,___,___,___,___,___,___
___,___,___,___,___,___,rn_,___,___,___,___,___
___,___,___,___,___,bb_,___,___,___,___,___,___
___,___,___,___,___,___,___,___,rn_,___,___,___
___,___,___,___,___,___,___,___,___,___,___,___
___,___,___,___,___,___,___,___,___,___,___,___