lv3_S,,,,,,,,,,,
op_,op_,no_,lk_,,,,,,,,
sp_,___,___,___,___,___,___,___,___,___,___,sp_
___,ks_,___,___,___,___,___,___,___,___,___,___
___,___,___,ks_,___,___,___,___,___,___,___,___
ks_,___,___,___,___,___,___,___,___,___,___,___
___,___,___,___,___,___,cs_,___,___,___,___,___
___,ks_,___,___,___,___,___,___,___,___,___,___
sp_,___,___,___,___,___,___,___,___,___,___,sp_