lv3_S,,,,,,,,,,,
cl_,no_,lk_,no_,,,,,,,,
sp_,___,___,___,___,___,___,___,___,___,___,sp_
___,___,___,zb_,___,___,___,___,___,___,___,___
___,___,___,___,___,___,___,___,___,___,___,___
___,___,___,bl_,___,___,bl_,___,___,___,___,___
___,___,zb_,___,___,___,___,___,___,___,___,___
___,___,___,___,___,___,___,___,___,___,___,___
sp_,___,___,___,___,___,___,___,___,___,___,sp_