lv3_S,,,,,,,,,,,
op_,no_,no_,no_,,,,,,,,
___,___,rn_,___,___,___,___,___,bl_,bl_,bl_,bl_
___,___,___,___,___,___,___,___,bl_,bl_,bl_,bl_
___,___,___,rn_,___,___,___,___,rn_,bl_,bl_,bl_
___,___,___,___,___,bb_,___,___,___,___,___,sr_
rn_,___,___,___,___,___,rn_,___,___,bl_,bl_,bl_
___,___,rn_,___,___,___,___,___,bl_,bl_,bl_,bl_
___,___,rn_,rn_,___,___,___,___,bl_,bl_,bl_,bl_