lv3_S,,,,,,,,,,,
no_,op_,op_,no_,,,,,,,,
___,___,___,___,___,___,___,___,zb_,___,___,___
___,___,___,___,___,___,zb_,___,___,___,___,___
bu_,___,___,___,___,___,___,___,ks_,___,___,___
___,___,___,___,___,ky_,ks_,bu_,___,___,___,___
___,___,___,___,___,___,___,___,___,___,___,___
___,___,___,___,___,___,bu_,___,___,___,___,___
___,___,___,___,___,___,___,___,___,___,___,___