lv4_S,,,,,,,,,,,
no_,no_,op_,op_,,,,,,,,
___,___,___,ks_,___,___,___,___,ks_,___,___,___
___,ks_,bl_,___,___,___,___,___,___,bl_,ks_,___
___,___,___,___,___,___,___,ks_,___,___,___,___
___,___,___,___,ks_,___,___,___,___,___,___,___
___,___,___,___,___,___,ks_,ky_,___,___,___,___
___,___,bl_,___,___,___,___,___,ks_,bl_,___,___
___,___,___,___,___,___,___,___,___,___,___,___