lv4_S,,,,,,,,,,,
op_,no_,op_,no_,,,,,,,,
___,___,___,___,___,___,bz_,___,___,___,___,___
___,wa_,wa_,wa_,___,___,___,bz_,wa_,wa_,wa_,___
___,wa_,___,___,bz_,___,ky_,___,___,bz_,wa_,___
___,wa_,___,wa_,wa_,wa_,wa_,wa_,wa_,___,wa_,___
___,wa_,___,___,___,___,___,___,___,___,wa_,___
___,wa_,wa_,wa_,___,___,bz_,___,wa_,wa_,wa_,___
___,___,___,___,___,___,___,___,___,___,___,___