lv4_S,,,,,,,,,,,
op_,cl_,no_,bb_,,,,,,,,
___,___,___,___,___,___,___,___,___,___,___,___
___,___,___,Vi_,___,___,Vi_,___,___,___,___,___
___,___,___,___,___,___,___,___,Vi_,___,___,___
___,___,___,___,___,___,___,___,___,___,___,___
___,___,___,bj_,___,___,Vi_,bl_,___,___,___,___
___,___,Vi_,___,___,___,___,___,___,___,___,___
___,___,___,___,___,___,___,___,___,___,___,___