lv4_S,,,,,,,,,,,
lk_,lk_,op_,no_,,,,,,,,
___,___,___,___,___,___,___,___,___,___,___,bu_
___,___,Vi_,___,bu_,___,___,___,___,___,___,___
wa_,wa_,wa_,wa_,wa_,wa_,wa_,wa_,wa_,wa_,wa_,wa_
___,___,___,___,___,___,___,___,___,___,___,___
___,Vi_,___,___,___,___,___,___,Vi_,___,___,___
___,___,___,___,___,___,___,___,___,___,___,___
___,___,___,___,___,___,___,___,___,___,___,___