lv4_S,,,,,,,,,,,
op_,op_,no_,no_,,,,,,,,
___,___,b2_,___,___,___,___,___,___,___,___,b2_
___,b2_,___,___,___,b2_,Vi_,___,___,___,b2_,___
___,Vi_,___,___,b2_,___,___,Vi_,___,b2_,___,___
___,___,___,b2_,___,___,___,___,b2_,___,___,___
___,___,b2_,___,___,___,___,b2_,___,___,___,___
___,b2_,Vi_,___,___,Vi_,b2_,___,___,___,b2_,___
b2_,___,___,___,___,___,___,___,___,b2_,___,___