lv4_S,,,,,,,,,,,
no_,no_,op_,no_,,,,,,,,
___,___,___,___,___,___,___,___,___,___,___,___
___,bl_,bl_,bl_,bl_,bl_,bl_,bl_,bl_,bl_,bl_,___
___,bl_,___,___,rs_,___,___,ls_,___,___,bl_,___
___,bl_,___,rs_,___,tr_,___,___,ls_,___,bl_,___
___,bl_,___,___,___,___,___,___,___,___,bl_,___
___,bl_,bl_,bl_,bl_,___,___,bl_,bl_,bl_,bl_,___
___,___,___,___,___,___,___,___,___,___,___,___