lv4_S,,,,,,,,,,,
lk_,no_,no_,lk_,,,,,,,,
bl_,bl_,bl_,bl_,bl_,___,___,bl_,bl_,bl_,bl_,bl_
bl_,bl_,bl_,bl_,___,___,___,___,bl_,bl_,bl_,bl_
bl_,bl_,___,___,___,___,___,___,___,___,bl_,bl_
___,___,___,___,___,___,___,___,___,___,___,___
___,___,___,___,___,___,___,___,___,___,___,___
___,___,bl_,___,___,___,___,___,___,bl_,___,___
___,___,___,___,___,___,___,___,___,___,___,hc_