lv4_S,,,,,,,,,,,
no_,no_,no_,op_,,,,,,,,
___,___,___,___,___,___,___,___,___,bu_,___,___
___,___,bz_,___,___,___,___,___,___,___,___,sr_
___,___,___,___,___,___,___,ll_,___,___,___,___
___,___,___,bj_,___,___,bl_,___,___,___,___,___
___,___,___,___,___,___,___,___,___,___,___,bz_
___,___,ll_,___,___,___,___,___,___,___,___,___
___,___,___,___,___,___,___,___,___,bu_,___,___