lv4_S,,,,,,,,,,,
no_,no_,no_,lk_,,,,,,,,
___,b2_,___,b2_,___,___,___,Vi_,___,___,Vi_,___
___,b2_,___,b2_,b2_,b2_,___,b2_,b2_,b2_,___,___
___,b2_,Vi_,___,___,b2_,___,cs_,___,b2_,b2_,b2_
___,b2_,___,b2_,___,b2_,___,___,___,b2_,___,___
___,b2_,b2_,b2_,___,b2_,___,___,___,b2_,___,___
___,___,Vi_,___,___,b2_,___,b2_,___,b2_,___,b2_
___,___,___,___,___,___,___,b2_,___,___,___,b2_