lv4_S,,,,,,,,,,,
op_,op_,lk_,no_,,,,,,,,
___,___,Vi_,___,___,___,___,___,___,Vi_,___,___
___,wa_,wa_,wa_,___,___,___,___,___,wa_,wa_,___
___,wa_,___,___,___,___,___,Vi_,___,___,wa_,___
___,wa_,___,wa_,wa_,wa_,wa_,wa_,wa_,___,wa_,___
___,wa_,Vi_,___,___,___,___,___,Vi_,___,wa_,___
___,wa_,wa_,wa_,___,___,___,___,wa_,wa_,wa_,___
___,___,___,___,___,___,___,___,___,___,___,___