lv4_S,,,,,,,,,,,
op_,lk_,op_,no_,,,,,,,,
___,___,___,___,___,___,___,___,___,___,___,___
___,___,___,___,Vi_,___,___,___,___,___,___,___
___,___,bl_,___,___,___,___,___,___,bl_,___,___
___,___,___,___,___,___,Vi_,___,___,___,___,___
___,___,bl_,Vi_,___,___,___,___,___,bl_,___,___
___,___,___,___,___,___,___,___,___,___,___,___
___,___,___,___,___,___,___,___,___,___,___,___