lv4_S,,,,,,,,,,,
op_,no_,no_,op_,,,,,,,,
___,___,___,___,___,___,___,___,___,___,___,___
___,r2_,___,___,r2_,___,___,l2_,___,___,l2_,___
___,___,___,___,___,___,___,___,___,___,___,___
___,r2_,___,___,r2_,___,___,l2_,___,___,l2_,___
___,___,___,___,___,d2_,d2_,___,___,___,___,___
___,r2_,___,d2_,r2_,d2_,d2_,l2_,d2_,___,l2_,___
___,___,___,d2_,d2_,d2_,d2_,d2_,d2_,___,___,___