lv4_S,,,,,,,,,,,
bb_,no_,lk_,op_,,,,,,,,
___,BG_,___,___,___,___,___,___,___,___,BG_,BG_
___,wa_,wa_,wa_,wa_,wa_,wa_,wa_,wa_,wa_,wa_,___
___,wa_,wa_,wa_,wa_,wa_,wa_,wa_,wa_,wa_,wa_,___
___,wa_,wa_,___,___,___,___,BG_,___,wa_,wa_,___
___,wa_,wa_,___,___,___,BG_,___,___,wa_,wa_,___
___,wa_,wa_,wa_,wa_,___,___,wa_,wa_,wa_,wa_,___
___,wa_,wa_,wa_,wa_,___,___,wa_,wa_,wa_,wa_,mp_