lv4_S,,,,,,,,,,,
cl_,bb_,cl_,no_,,,,,,,,
___,___,___,___,___,___,___,___,___,___,___,___
___,___,___,___,___,___,___,___,___,___,___,___
___,___,mc_,___,___,___,___,___,___,___,___,___
___,bl_,___,___,___,___,___,___,___,___,bl_,___
___,___,___,___,___,___,___,___,___,___,___,___
___,___,___,bl_,___,___,___,___,bl_,___,___,___
st_,___,___,___,___,___,___,___,___,___,___,so_