lv4_S,,,,,,,,,,,
no_,op_,no_,no_,,,,,,,,
___,___,___,___,___,___,___,___,ks_,___,___,___
___,___,___,___,___,___,___,___,___,___,___,___
___,___,___,ks_,ks_,___,___,___,___,___,___,___
ks_,___,___,___,___,___,ky_,___,___,___,___,___
___,___,___,___,___,___,___,___,___,___,___,___
___,ks_,___,ks_,ks_,___,___,___,___,ks_,___,___
___,___,___,___,___,___,___,___,___,___,___,___