lv4_S,,,,,,,,,,,
lk_,cl_,no_,lk_,,,,,,,,
wa_,wa_,wa_,wa_,wa_,___,___,wa_,wa_,wa_,wa_,wa_
wa_,___,___,___,wa_,___,___,___,___,wa_,___,wa_
wa_,___,wa_,___,wa_,___,wa_,wa_,Vi_,wa_,Vi_,wa_
___,___,wa_,___,wa_,___,___,wa_,___,wa_,___,___
wa_,___,wa_,___,wa_,wa_,Vi_,wa_,Vi_,wa_,Vi_,wa_
wa_,___,wa_,___,___,___,___,wa_,___,___,___,wa_
wa_,wa_,wa_,wa_,wa_,___,___,wa_,wa_,wa_,wa_,wa_