lv4_S,,,,,,,,,,,
no_,op_,bb_,lk_,,,,,,,,
wa_,wa_,wa_,wa_,wa_,___,___,wa_,wa_,wa_,wa_,wa_
wa_,___,___,___,wa_,wa_,wa_,wa_,___,___,___,wa_
wa_,ks_,wa_,wa_,wa_,___,ks_,wa_,wa_,wa_,ks_,wa_
___,___,wa_,___,___,ks_,ky_,___,___,wa_,ks_,ks_
wa_,___,wa_,wa_,wa_,___,___,wa_,wa_,wa_,___,wa_
wa_,___,___,___,wa_,wa_,wa_,wa_,___,___,ks_,wa_
wa_,wa_,wa_,wa_,wa_,___,___,wa_,wa_,wa_,wa_,wa_