lv4_S,,,,,,,,,,,
no_,no_,op_,op_,,,,,,,,
sp_,___,___,___,___,___,___,___,___,___,___,sp_
___,___,___,___,___,___,___,___,___,___,___,___
___,___,b2_,___,___,___,___,___,___,b2_,___,___
___,b2_,sp_,___,___,___,___,___,___,sp_,b2_,___
___,___,b2_,___,___,___,___,___,___,b2_,___,___
___,___,___,___,___,___,___,___,___,___,___,___
sp_,___,___,___,___,___,___,___,___,___,___,sp_