lv5_S,,,,,,,,,,,
lk_,no_,no_,no_,,,,,,,,
___,___,___,___,___,___,___,___,___,___,___,___
___,___,___,___,___,___,___,___,___,___,___,___
___,___,Gi_,___,___,bl_,bl_,___,___,___,___,___
___,___,___,___,___,bl_,bl_,___,___,___,___,___
___,___,___,Gi_,___,bl_,bl_,Gi_,___,___,___,___
___,Gi_,Gi_,___,___,___,___,___,Gi_,___,___,___
___,___,___,___,___,___,___,___,___,___,___,___