lv5_S,,,,,,,,,,,
lk_,bb_,no_,no_,,,,,,,,
___,___,___,___,___,___,___,___,___,___,___,___
___,___,___,___,___,___,___,___,___,___,___,___
wa_,wa_,wa_,wa_,wa_,wa_,wa_,wa_,wa_,wa_,wa_,wa_
___,___,___,ks_,___,___,___,___,___,___,___,___
___,___,ks_,___,___,ky_,___,ks_,___,___,___,___
___,ks_,___,___,___,___,___,___,___,___,ks_,___
___,___,___,___,ks_,___,___,___,ks_,___,___,___