lv5_S,,,,,,,,,,,
no_,bb_,no_,no_,,,,,,,,
___,___,___,___,___,___,___,___,bn_,___,___,___
___,___,___,bn_,___,___,bl_,___,___,___,___,___
___,bn_,___,___,___,bl_,___,bl_,___,___,___,___
___,___,___,___,bj_,___,___,___,bl_,___,___,___
___,___,bn_,___,___,bl_,___,bl_,___,___,___,___
bn_,___,___,___,___,___,bl_,___,___,___,___,___
___,___,___,___,___,___,___,___,___,___,___,___