lv5_S,,,,,,,,,,,
no_,lk_,no_,op_,,,,,,,,
___,___,___,___,___,___,___,___,___,Gi_,___,___
___,wa_,wa_,wa_,wa_,wa_,wa_,wa_,wa_,wa_,wa_,___
___,wa_,___,___,___,Gi_,___,___,___,___,wa_,___
___,wa_,___,___,Gi_,___,___,___,___,___,wa_,___
___,wa_,___,Gi_,___,___,ky_,___,___,___,wa_,___
___,wa_,wa_,wa_,wa_,wa_,wa_,wa_,wa_,wa_,wa_,___
___,___,___,___,___,___,___,___,___,Gi_,___,___