lv5_S,,,,,,,,,,,
no_,op_,lk_,no_,,,,,,,,
___,___,___,___,___,___,___,___,___,___,___,___
___,wa_,wa_,wa_,wa_,wa_,wa_,wa_,wa_,wa_,wa_,___
___,wa_,wa_,wa_,wa_,wa_,wa_,wa_,wa_,wa_,wa_,___
___,wa_,wa_,___,___,___,___,___,___,wa_,wa_,___
___,wa_,wa_,___,___,___,mp_,___,___,wa_,wa_,___
___,wa_,wa_,wa_,wa_,___,___,wa_,wa_,wa_,wa_,___
___,wa_,wa_,wa_,wa_,___,___,wa_,wa_,wa_,wa_,___