lv5_S,,,,,,,,,,,
cl_,lk_,op_,bb_,,,,,,,,
___,___,___,ky_,___,___,Gi_,___,___,___,___,___
___,___,___,Gi_,___,___,___,___,___,___,___,Gi_
wa_,wa_,wa_,wa_,wa_,wa_,wa_,wa_,wa_,wa_,wa_,wa_
___,___,___,___,___,___,___,___,___,___,___,___
___,___,___,___,___,___,___,___,___,___,___,___
___,___,___,___,___,___,___,___,___,___,___,___
___,___,___,___,___,___,___,___,___,___,___,___