lv5_S,,,,,,,,,,,
op_,op_,op_,no_,,,,,,,,
___,___,___,___,___,___,___,___,___,___,___,___
___,r2_,___,r2_,___,___,___,___,l2_,___,l2_,___
___,___,___,___,___,___,___,___,___,___,___,___
___,r2_,___,r2_,___,___,___,___,l2_,___,l2_,___
___,___,___,___,___,d2_,d2_,___,___,___,___,___
___,r2_,___,r2_,d2_,d2_,d2_,d2_,l2_,___,l2_,___
___,___,__,d2_,d2_,d2_,d2_,d2_,d2_,___,___,___