lv5_S,,,,,,,,,,,
bb_,no_,no_,op_,,,,,,,,
___,___,___,___,___,___,___,___,___,___,___,___
___,___,___,___,___,___,___,___,___,___,___,___
___,___,bl_,bl_,___,___,___,___,bl_,bl_,___,___
___,___,bl_,bl_,___,___,___,___,bl_,bl_,___,___
___,___,bl_,bl_,___,___,ky_,___,bl_,bl_,___,___
___,___,___,___,___,___,___,___,___,___,___,___
___,___,___,___,___,___,___,___,___,___,___,___