lv5_S,,,,,,,,,,,
no_,cl_,op_,no_,,,,,,,,
___,___,___,___,___,___,___,___,wa_,___,___,___
___,___,___,___,gz_,___,___,___,wa_,___,___,___
gz_,___,___,gz_,___,___,___,___,wa_,___,___,___
___,___,gz_,___,___,___,___,___,wa_,___,___,___
___,___,___,___,___,___,ky_,___,wa_,___,___,___
___,___,___,gz_,___,___,___,___,wa_,___,___,___
___,___,___,___,___,___,___,___,wa_,___,___,___