lv5_S,,,,,,,,,,,
cl_,lk_,op_,no_,,,,,,,,
st_,___,___,___,___,___,___,___,___,___,___,so_
___,___,___,___,___,___,___,hc_,___,___,___,___
___,___,___,___,___,___,___,___,___,___,___,___
___,___,___,___,___,___,___,___,___,___,___,___
___,___,___,___,___,___,___,___,___,___,___,___
___,___,___,___,___,___,___,___,___,___,___,___
st_,___,___,___,___,___,___,___,___,___,___,so_