lv5_S,,,,,,,,,,,
op_,no_,no_,op_,,,,,,,,
wa_,wa_,wa_,wa_,wa_,___,___,wa_,wa_,wa_,wa_,wa_
wa_,___,___,___,wa_,___,___,___,___,wa_,___,wa_
wa_,___,wa_,gz_,wa_,___,wa_,wa_,___,wa_,gz_,wa_
___,___,wa_,___,wa_,___,___,wa_,___,wa_,gz_,___
wa_,___,wa_,___,wa_,wa_,fr_,wa_,___,wa_,gz_,wa_
wa_,___,wa_,___,___,___,___,wa_,gz_,___,___,wa_
wa_,wa_,wa_,wa_,wa_,___,___,wa_,wa_,wa_,wa_,wa_