lv5_S,,,,,,,,,,,
lk_,op_,op_,cl_,,,,,,,,
___,___,___,___,___,___,___,___,___,___,___,___
___,___,___,___,___,___,___,___,___,___,___,___
___,___,___,do_,___,bb_,___,do_,___,___,___,___
___,___,___,___,___,___,___,___,___,___,___,___
___,___,___,___,___,___,___,___,___,___,___,___
___,___,___,___,___,do_,___,___,___,___,___,___
___,___,___,___,___,___,___,___,___,___,___,___