lv5_S,,,,,,,,,,,
no_,no_,op_,lk_,,,,,,,,
___,___,___,___,___,___,___,___,___,___,___,___
___,wa_,wa_,wa_,___,___,___,___,wa_,wa_,wa_,___
___,wa_,___,___,Gi_,___,___,ks_,___,___,wa_,___
___,wa_,Gi_,wa_,wa_,wa_,wa_,wa_,wa_,___,wa_,___
___,wa_,___,___,___,___,ky_,___,___,ks_,wa_,___
___,wa_,wa_,wa_,___,___,___,___,wa_,wa_,wa_,___
___,___,___,___,___,___,___,___,___,___,___,___