lv5_S,,,,,,,,,,,
no_,lk_,no_,bb_,,,,,,,,
___,___,___,___,___,___,___,___,___,___,___,sr_
___,bn_,___,___,___,___,___,___,___,___,___,___
___,___,___,bn_,bn_,___,___,___,___,___,___,___
___,___,___,___,___,bj_,___,___,___,___,___,___
___,___,___,___,___,___,___,___,___,___,___,___
___,bn_,___,bn_,bn_,___,___,___,___,___,___,___
___,___,___,___,___,___,___,___,___,___,___,___