lv5_S,,,,,,,,,,,
cl_,bb_,no_,bb_,,,,,,,,
___,___,___,___,___,___,___,___,___,___,___,___
___,___,Gi_,___,Gi_,___,___,___,___,___,___,___
___,___,bl_,___,___,___,___,___,___,bl_,___,___
___,___,___,___,Gi_,___,___,___,___,___,___,___
___,Gi_,bl_,___,___,___,___,___,___,bl_,___,___
___,___,___,___,___,___,___,___,___,___,___,___
___,Gi_,___,___,___,___,___,___,___,___,___,___