lv5_S,,,,,,,,,,,
op_,no_,op_,no_,,,,,,,,
wa_,wa_,wa_,wa_,wa_,___,___,wa_,wa_,wa_,wa_,wa_
wa_,___,___,___,wa_,___,___,___,rn_,wa_,___,wa_
wa_,___,wa_,rn_,wa_,rn_,wa_,wa_,___,wa_,___,wa_
___,___,wa_,___,wa_,___,___,wa_,___,wa_,___,___
wa_,___,wa_,___,wa_,wa_,cs_,wa_,___,wa_,___,wa_
wa_,___,wa_,___,___,___,___,wa_,___,___,___,wa_
wa_,wa_,wa_,wa_,wa_,___,___,wa_,wa_,wa_,wa_,wa_