lv5_S,,,,,,,,,,,
no_,no_,lk_,lk_,,,,,,,,
___,___,___,___,___,___,___,___,___,___,___,___
___,___,___,___,___,bl_,___,___,___,___,___,___
___,___,___,___,bl_,___,bl_,___,___,___,___,___
___,___,___,bj_,___,___,___,bl_,___,___,___,___
___,___,___,___,bl_,___,bl_,___,___,___,___,___
___,___,___,___,___,bl_,___,___,___,___,___,___
___,___,___,___,___,___,___,___,___,___,___,___