lv7_S,,,,,,,,,,,
bb_,op_,op_,op_,,,,,,,,
___,___,___,___,ks_,___,___,___,___,___,___,___
___,___,b2_,b2_,b2_,b2_,b2_,b2_,b2_,b2_,___,___
___,ks_,b2_,___,___,ks_,___,___,___,b2_,ks_,___
___,___,b2_,ks_,___,___,___,___,___,b2_,___,ks_
ks_,___,b2_,___,___,___,___,___,___,b2_,___,___
___,___,b2_,b2_,b2_,b2_,b2_,b2_,b2_,b2_,ks_,___
___,___,___,___,___,___,___,___,___,___,___,___