lv7_S,,,,,,,,,,,
lk_,lk_,no_,bb_,,,,,,,,
___,___,___,gb_,___,___,___,___,___,___,___,___
___,___,___,___,___,___,___,___,___,___,___,___
___,___,___,___,___,___,___,gb_,___,___,gb_,___
___,___,___,___,___,___,___,___,gb_,___,___,___
___,___,___,___,___,bb_,___,___,___,___,___,___
___,___,___,___,___,___,___,gb_,gb_,___,gb_,___
___,___,___,___,___,___,___,___,___,___,___,___