lv7_S,,,,,,,,,,,
no_,no,no,bb_,,,,,,,,
___,___,___,___,wm_,___,___,___,___,bu_,___,sr_
___,bl_,bl_,bl_,bl_,bl_,bl_,bl_,bl_,bl_,bl_,___
wm_,___,___,bu_,___,___,___,___,___,___,bl_,___
___,___,___,___,___,___,___,___,___,___,bl_,___
___,___,___,___,___,___,___,___,___,___,bl_,___
___,bl_,bl_,bl_,bl_,bl_,bl_,bl_,bl_,bl_,bl_,wm_
bu_,___,wm_,___,___,___,___,wm_,___,___,___,___