lv7_S,,,,,,,,,,,
bb_,op_,op_,bb_,,,,,,,,
___,___,___,gb_,___,___,___,___,___,___,___,___
___,___,___,___,___,___,___,___,___,gb_,___,___
___,___,___,gb_,___,___,___,___,___,___,___,___
___,___,___,___,so_,___,bb_,st_,gb_,___,___,___
___,___,___,___,___,___,___,___,___,___,___,___
___,___,gb_,___,___,___,___,___,___,___,___,___
___,___,___,___,___,___,___,___,___,___,___,___