lv7_S,,,,,,,,,,,
lk_,cl_,no_,no_,,,,,,,,
___,___,___,___,___,___,___,___,___,go_,___,fr_
___,bl_,___,bl_,___,bl_,bl_,___,bl_,___,bl_,___
___,___,___,gb_,___,___,go_,___,___,___,___,___
___,bl_,___,bl_,___,bl_,bl_,___,bl_,___,bl_,___
___,___,go_,___,___,gb_,___,___,___,___,___,___
___,bl_,___,bl_,___,bl_,bl_,___,bl_,___,bl_,___
___,___,___,___,___,___,___,___,___,gb_,___,___