lv7_S,,,,,,,,,,,
no_,op_,no_,op_,,,,,,,,
st_,___,___,___,___,___,___,___,___,___,___,so_
___,___,___,___,___,___,___,___,___,___,___,___
___,___,___,___,___,___,___,___,___,___,___,___
___,___,___,___,___,___,bb_,___,___,___,___,___
___,___,___,___,___,___,___,___,___,___,___,___
___,___,___,___,___,___,___,___,___,___,___,___
st_,___,___,___,___,___,___,___,___,___,___,so_