lv7_S,,,,,,,,,,,
no_,no_,bb_,op_,,,,,,,,
___,___,___,___,___,sf_,sf_,___,___,___,___,___
wa_,wa_,wa_,wa_,wa_,wa_,wa_,wa_,wa_,wa_,wa_,wa_
___,___,___,___,sf_,___,___,___,___,___,sf_,___
___,___,sf_,___,___,___,sf_,___,___,sf_,___,___
___,___,___,___,___,___,___,___,sf_,___,___,___
wa_,wa_,wa_,wa_,wa_,wa_,wa_,wa_,wa_,wa_,wa_,wa_
___,___,___,___,___,___,___,___,___,___,___,___