lv7_S,,,,,,,,,,,
op_,no_,no_,no_,,,,,,,,
___,___,___,___,___,___,___,___,___,___,___,___
___,___,___,___,___,___,___,___,___,___,___,___
ro_,___,___,___,___,___,___,___,___,___,___,___
___,___,___,___,so_,___,ky_,st_,___,___,___,___
___,ro_,___,___,ro_,___,___,___,___,___,___,___
___,___,___,___,___,___,___,___,___,___,___,___
ro_,___,___,___,___,___,ro_,___,___,___,___,___