lv7_S,,,,,,,,,,,
no_,no_,no_,op_,,,,,,,,
___,___,___,sf_,___,___,___,___,wa_,___,___,___
___,___,___,___,___,___,___,___,wa_,___,___,___
___,___,___,___,___,___,sf_,___,wa_,sf_,sf_,___
___,___,___,___,___,___,___,___,wa_,___,___,___
___,___,___,___,___,___,___,___,wa_,___,___,___
___,___,sf_,___,___,___,sf_,___,wa_,sf_,sf_,___
___,___,___,___,___,___,___,___,wa_,___,___,___