lv7_S,,,,,,,,,,,
no_,cl_,no_,bb_,,,,,,,,
___,___,___,___,___,___,___,bl_,bl_,bl_,bl_,bl_
___,___,___,___,___,___,___,___,___,bl_,bl_,bl_
___,___,___,___,___,___,___,___,___,___,bl_,bl_
___,___,___,___,___,___,hc_,___,___,aq_,___,___
___,___,___,___,___,___,___,___,___,___,bl_,bl_
___,___,___,___,___,___,___,___,___,bl_,bl_,bl_
___,___,___,___,___,___,___,bl_,bl_,bl_,bl_,bl_