lv7_S,,,,,,,,,,,
op_,no_,no_,op_,,,,,,,,
___,___,___,___,___,___,___,___,___,___,___,___
___,___,___,___,___,___,___,___,___,___,___,___
___,___,bl_,bl_,mo_,___,___,mo_,bl_,bl_,___,___
___,___,bl_,bl_,___,___,___,___,bl_,bl_,___,___
___,___,bl_,bl_,___,___,bb_,___,bl_,bl_,___,___
___,___,___,___,___,___,___,___,___,___,___,___
___,___,___,___,___,___,___,___,___,___,___,___