lv7_S,,,,,,,,,,,
op_,cl_,bb_,op_,,,,,,,,
___,___,___,___,go_,___,___,___,___,___,gb_,___
___,___,___,___,___,___,___,go_,___,gb_,___,___
___,___,bl_,___,___,___,___,___,___,bl_,___,___
___,___,___,___,___,___,___,___,___,___,___,___
___,___,bl_,gb_,___,___,___,___,___,bl_,___,___
___,___,___,___,___,___,___,___,___,___,___,___
___,___,___,___,___,___,___,go_,___,___,___,___