lv7_S,,,,,,,,,,,
cl_,no_,op_,no_,,,,,,,,
___,___,___,ks_,___,___,___,___,___,gb_,___,___
___,ks_,bu_,___,___,___,___,___,___,___,ks_,___
wa_,wa_,wa_,wa_,wa_,wa_,wa_,wa_,wa_,wa_,wa_,wa_
___,___,___,___,___,___,___,___,___,___,___,___
___,___,___,___,bu_,___,___,gb_,___,___,___,___
___,___,___,___,___,___,___,___,gb_,___,___,___
___,___,___,___,___,___,___,___,___,___,___,___