lv7_S,,,,,,,,,,,
no_,no_,no_,cl_,,,,,,,,
st_,___,___,___,___,___,___,___,___,___,gb_,so_
___,___,___,___,___,___,___,___,___,___,___,___
___,___,___,___,___,___,___,___,___,___,___,___
___,___,___,gb_,gb_,___,ky_,___,___,___,___,gb_
___,___,___,___,___,___,___,___,___,___,___,___
___,___,gb_,___,___,___,___,___,___,___,___,___
st_,___,___,___,___,___,___,___,___,___,___,so_