lv7_S,,,,,,,,,,,
no_,cl_,cl_,bb_,,,,,,,,
___,___,___,___,___,___,___,___,___,___,___,___
___,___,___,___,___,go_,___,___,___,gb_,___,___
___,___,___,___,___,___,___,___,gb_,___,___,___
___,___,___,___,bl_,___,fr_,bl_,___,___,___,___
___,___,___,___,___,___,___,___,go_,___,___,___
___,___,___,___,___,___,go_,___,___,___,___,___
___,___,___,gb_,___,___,___,___,___,___,___,___