lv7_S,,,,,,,,,,,
op_,bb_,op_,no_,,,,,,,,
sp_,___,___,___,___,___,___,___,___,___,___,sp_
___,___,___,___,___,___,___,___,___,___,___,___
___,___,ks_,___,___,___,___,___,ks_,___,___,___
___,___,___,___,___,___,___,___,___,___,___,___
___,___,___,___,ks_,___,bb_,___,___,___,___,___
___,___,___,___,___,___,___,___,ks_,___,___,___
sp_,___,___,___,___,___,___,___,___,___,___,sp_