lv7_S,,,,,,,,,,,
cl_,bb_,no_,lk_,,,,,,,,
___,___,___,___,___,___,___,___,___,___,___,___
___,bl_,bl_,___,___,___,___,___,___,bl_,bl_,___
___,___,___,gb_,___,___,___,___,gb_,___,___,___
___,___,___,___,___,bl_,bl_,___,___,___,___,___
___,___,___,___,gb_,___,___,gb_,___,___,___,___
___,bl_,bl_,gb_,___,___,___,___,___,bl_,bl_,___
___,___,___,___,___,___,___,___,gb_,___,___,___