lv7_S,,,,,,,,,,,
cl_,op_,no_,op_,,,,,,,,
___,___,___,gb_,___,___,___,___,___,___,___,___
___,___,___,___,___,___,___,___,___,___,___,___
___,___,___,___,___,bl_,bl_,___,___,___,gb_,___
___,___,___,___,___,bl_,bl_,___,gb_,___,___,___
___,___,___,___,___,bl_,bl_,___,___,___,___,___
___,___,___,___,___,___,___,___,___,gb_,___,gb_
___,___,___,gb_,___,___,___,___,___,___,___,___