lv7_S,,,,,,,,,,,
lk_,op_,op_,no_,,,,,,,,
___,___,___,___,___,do_,___,___,___,___,___,___
___,___,___,___,___,___,___,___,___,___,___,___
___,___,___,___,___,___,___,___,___,___,___,___
___,___,___,___,___,fr_,___,___,do_,___,___,___
___,___,___,___,___,___,___,___,___,___,___,___
___,___,___,___,___,do_,___,___,___,___,___,___
___,___,___,___,___,___,___,___,___,___,___,___