lv7_S,,,,,,,,,,,
no_,bb_,op_,no_,,,,,,,,
___,___,___,___,do_,___,___,___,___,___,___,___
___,___,___,___,___,___,___,___,___,___,___,___
___,___,___,do_,___,___,___,___,___,___,___,___
___,___,___,___,st_,___,bb_,so_,___,___,___,___
___,___,___,___,___,___,___,___,___,___,___,___
___,___,___,___,___,do_,___,___,___,___,___,___
___,___,___,___,___,___,___,___,___,___,___,___