lv7_S,,,,,,,,,,,
bb_,lk_,cl_,no_,,,,,,,,
wa_,wa_,wa_,wa_,wa_,ks_,___,wa_,wa_,wa_,wa_,wa_
wa_,___,___,___,wa_,wa_,wa_,wa_,___,gb_,bu_,wa_
wa_,___,wa_,wa_,wa_,___,___,wa_,wa_,wa_,___,wa_
___,___,wa_,___,___,bu_,ks_,___,___,wa_,___,___
wa_,___,wa_,wa_,wa_,gb_,mp_,wa_,wa_,wa_,___,wa_
wa_,___,gb_,___,wa_,wa_,wa_,wa_,___,___,___,wa_
wa_,wa_,wa_,wa_,wa_,___,ks_,wa_,wa_,wa_,wa_,wa_