lv7_S,,,,,,,,,,,
no_,bb_,no_,bb_,,,,,,,,
___,___,___,gb_,___,___,___,___,___,___,___,___
___,___,___,___,___,___,bl_,___,gb_,go_,___,___
___,___,___,___,___,bl_,___,bl_,___,___,___,___
___,___,___,___,bl_,___,___,___,bl_,___,___,___
___,___,___,___,___,bl_,___,bl_,___,___,___,go_
___,___,___,___,___,___,bl_,go_,___,gb_,___,___
___,___,___,___,___,___,___,___,___,___,___,___