lv2_S,,,,,,,,,,,
op_,op_,cl_,no_,,,,,,,,
___,___,___,___,___,___,___,___,ro_,___,___,___
___,ro_,___,___,___,___,___,___,___,___,ro_,___
___,___,bl_,___,___,___,___,ro_,___,bl_,___,___
___,___,___,___,___,___,___,___,___,___,___,___
___,___,bl_,___,___,___,___,___,ro_,bl_,___,___
___,___,___,___,___,___,___,___,___,___,___,___
___,___,___,___,___,___,___,___,___,___,___,___
