lv2_S,,,,,,,,,,,
cl_,lk_,op_,no_,,,,,,,,
___,___,___,ro_,___,___,___,___,ro_,___,___,___
___,ro_,___,___,___,___,___,___,___,___,ro_,___
___,___,bl_,bl_,ro_,___,___,ro_,bl_,bl_,___,___
___,___,bl_,bl_,___,___,___,___,bl_,bl_,___,___
___,___,bl_,bl_,___,___,ro_,___,bl_,bl_,___,___
___,___,___,___,___,___,___,___,___,___,___,___
___,___,___,___,___,___,___,___,___,___,___,___
