lv2_S,,,,,,,,,,,
no_,op_,op_,cl_,,,,,,,,
___,___,___,___,___,___,___,___,___,___,___,___
___,ro_,bl_,___,___,___,___,___,___,bl_,___,___
___,___,___,ro_,___,___,___,___,___,___,___,___
ro_,___,___,___,___,___,___,__,___,___,___,___
___,___,___,___,___,___,___,___,___,___,___,___
___,ro_,bl_,___,___,___,___,___,___,bl_,___,___
___,___,___,___,___,___,___,___,ro_,___,___,___
