lv2_S,,,,,,,,,,,
bb_,no_,bb_,op_,,,,,,,,
sp_,___,___,ks_,___,___,___,___,___,___,___,sp_
___,ks_,___,___,___,___,___,___,___,___,___,___
___,___,___,___,ks_,___,___,___,___,___,___,___
___,___,___,___,___,___,bb_,___,___,___,___,___
___,___,___,ks_,___,___,___,___,___,___,___,___
___,___,___,___,___,___,___,___,___,___,___,___
sp_,___,___,___,___,___,___,___,___,___,___,sp_
