lv2_S,,,,,,,,,,,
bb_,no_,bb_,op_,,,,,,,,
so_,___,___,___,___,___,___,___,___,___,___,st_
___,___,___,___,___,___,___,___,___,___,gb_,___
___,___,___,___,___,___,___,___,___,___,___,___
___,___,___,___,___,___,mb_,___,___,___,___,gb_
___,___,___,___,___,___,___,___,___,___,___,___
___,___,___,___,___,___,___,___,___,___,gb_,___
so_,___,___,___,___,___,___,___,___,___,___,st_