lv2_S,,,,,,,,,,,
op_,lk_,op_,op_,,,,,,,,
___,___,___,___,___,___,___,___,ro_,___,___,___
___,bl_,___,bl_,___,bl_,bl_,___,bl_,___,bl_,___
___,___,___,___,___,___,___,ro_,___,___,___,___
___,bl_,___,bl_,___,bl_,bl_,___,bl_,___,bl_,___
___,___,___,___,___,___,___,___,ro_,___,___,___
___,bl_,___,bl_,___,bl_,bl_,___,bl_,___,bl_,___
___,___,___,___,___,___,___,___,___,___,___,___
