lv2_S,,,,,,,,,,,
cl_,bb_,cl_,no_,,,,,,,,
___,___,___,go_,___,___,___,___,___,___,___,___
___,bl_,___,bl_,___,bl_,bl_,___,bl_,___,bl_,___
___,___,___,___,go_,___,___,go_,___,___,___,___
___,bl_,___,bl_,___,bl_,bl_,___,bl_,___,bl_,___
___,___,___,go_,___,___,___,___,go_,___,___,___
___,bl_,___,bl_,___,bl_,bl_,___,bl_,___,bl_,___
___,___,___,___,___,___,___,___,___,___,___,___
