lv2_S,,,,,,,,,,,
op_,no_,bb_,lk_,,,,,,,,
___,___,___,sg_,___,___,___,___,___,___,___,___
___,___,___,___,___,___,___,___,___,___,___,___
___,___,___,___,___,___,sg_,___,___,___,___,___
___,___,___,___,___,___,___,___,___,___,___,sg_
___,___,___,___,___,___,___,___,___,___,___,___
___,___,___,___,___,___,___,___,___,___,sg_,___
___,___,___,sg_,___,___,___,___,___,___,___,___
