lv2_S,,,,,,,,,,,
bb_,no_,bb_,lk_,,,,,,,,
___,___,___,sg_,___,___,___,___,___,___,___,___
___,___,bl_,___,___,___,___,___,___,bl_,___,___
___,___,___,___,sg_,___,___,sg_,___,___,___,___
___,___,___,___,___,___,sg_,___,___,___,___,___
___,___,___,sg_,___,___,mp_,___,___,___,___,___
___,___,bl_,___,___,___,___,___,___,bl_,___,___
___,___,___,___,___,___,___,___,___,___,___,___
