lv2_S,,,,,,,,,,,
bb_,no_,no_,lk_,,,,,,,,
___,___,___,sg_,___,___,___,___,___,___,___,cs_
___,___,___,___,___,___,___,___,___,___,sg_,___
___,___,___,___,___,bl_,bl_,___,sg_,___,___,___
___,___,___,___,___,bl_,bl_,___,___,___,___,sg_
___,___,___,___,___,bl_,bl_,___,sg_,___,___,___
___,___,___,___,___,___,___,___,___,___,___,___
___,___,___,sg_,___,___,___,___,___,___,___,___
