lv2_S,,,,,,,,,,,
op_,no_,no_,op_,,,,,,,,
___,___,ro_,___,___,___,___,___,___,___,___,___
___,___,___,___,___,___,___,___,___,___,ro_,___
___,___,___,___,___,___,___,___,___,___,___,___
___,___,___,___,___,___,___,___,___,___,___,ro_
___,___,___,___,___,___,___,___,ro_,___,___,___
___,___,___,___,___,___,___,___,___,___,ro_,___
___,___,___,___,___,___,___,___,___,___,___,___
