lv2_S,,,,,,,,,,,
op_,op_,op_,no_,,,,,,,,
___,___,___,___,___,___,___,___,___,___,___,___
___,r2_,___,___,r2_,___,___,l2_,___,___,l2_,___
___,___,___,___,___,bbbbbbbb_,___,___,___,___,___,___
___,r2_,___,___,r2_,kykykyky_,___,l2_,___,___,l2_,___
___,___,___,___,___,d2_,d2_,___,___,___,___,___
___,r2_,___,d2_,r2_,d2_,d2_,l2_,d2_,___,l2_,___
___,___,___,d2_,d2_,d2_,d2_,d2_,d2_,___,___,___
