lv2_S,,,,,,,,,,,
op_,lk_,op_,no_,,,,,,,,
___,___,___,___,___,___,___,___,go_,___,___,___
___,bl_,bl_,___,___,___,___,___,___,bl_,bl_,___
___,___,___,go_,___,go_,___,___,___,___,___,___
___,___,___,___,___,bl_,bl_,___,___,___,___,___
___,___,___,go_,___,go_,___,___,___,___,___,___
___,bl_,bl_,___,___,___,___,___,___,bl_,bl_,___
___,___,___,___,___,___,___,___,___,___,___,___
