lv2_S,,,,,,,,,,,
no_,op_,no_,no_,,,,,,,,
___,___,___,___,___,___,___,___,___,___,___,___
___,ro_,___,___,___,___,___,___,___,___,___,___
___,___,___,ro_,___,___,___,___,___,___,___,___
ro_,___,___,___,___,___,ky_,___,___,___,___,___
___,___,___,ro_,___,___,___,___,___,___,___,___
___,ro_,___,___,___,___,___,___,___,___,___,___
___,___,___,___,___,___,___,___,ro_,___,___,___
