lv1_S,,,,,,,,,,,
no_,op_,no_,no_,,,,,,,,
sp_,___,___,___,___,___,___,___,___,___,___,sp_
___,___,___,___,___,___,bl_,___,___,___,___,___
___,___,___,___,___,bl_,___,bl_,___,___,___,___
___,___,___,___,bj_,___,sr_,___,bl_,___,___,___
___,___,___,___,___,bl_,___,bl_,___,___,___,___
___,___,___,___,___,___,bl_,___,___,___,___,___
sp_,___,___,___,___,___,___,___,___,___,___,sp_