lv1_S,,,,,,,,,,,
no_,op_,bb_,lk_,,,,,,,,
___,___,___,___,___,___,___,go_,___,___,___,___
___,___,___,___,___,___,bm_,___,___,go_,___,___
___,___,bl_,___,___,___,___,___,___,bl_,___,___
___,___,___,___,___,___,___,___,___,___,___,___
___,___,bl_,___,___,___,___,go_,___,bl_,___,___
___,___,___,___,___,___,___,___,___,___,___,___
___,___,___,___,___,___,___,___,___,___,___,___