lv1_S,,,,,,,,,,,
bb_,op_,op_,op_,,,,,,,,
___,___,___,___,___,___,___,___,sf_,___,___,___
___,___,___,___,___,___,ky_,___,___,___,___,___
___,___,bl_,___,sf_,___,___,sf_,___,bl_,___,___
___,___,___,___,___,___,sf_,___,___,___,___,___
___,___,bl_,___,___,___,___,___,___,bl_,___,___
___,___,___,sf_,___,___,___,___,___,___,___,___
___,___,___,___,___,___,___,___,___,___,___,___