lv1_S,,,,,,,,,,,
op_,no_,lk_,no_,,,,,,,,
___,___,___,___,___,___,___,___,sf_,___,___,___
___,___,___,___,___,___,___,___,___,___,___,___
___,___,___,___,sf_,bl_,bl_,sf_,___,___,___,___
___,___,___,___,___,bl_,bl_,___,___,___,___,___
___,___,___,___,___,bl_,bl_,___,___,___,___,___
___,___,___,___,___,___,___,___,___,___,___,___
___,___,___,___,___,___,___,___,___,___,___,___
