lv1_S,,,,,,,,,,,
op_,lk_,bb_,op_,,,,,,,,
___,___,sg_,___,___,___,___,sg_,___,___,___,___
___,bl_,bl_,___,___,___,___,___,___,bl_,bl_,___
___,___,___,sg_,___,___,___,___,sg_,___,___,___
___,___,___,___,___,bl_,bl_,___,___,___,mp_,___
___,___,___,___,___,___,___,___,___,___,___,___
___,bl_,bl_,sg_,___,___,___,___,___,bl_,bl_,___
___,___,___,___,___,___,___,___,___,___,___,___