lv1_S,,,,,,,,,,,
no_,no_,lk_,lk_,,,,,,,,
___,___,___,___,___,___,___,___,go_,___,___,___
___,wa_,wa_,wa_,___,___,ky_,___,wa_,wa_,wa_,___
___,wa_,___,___,___,___,___,go_,___,___,wa_,___
___,wa_,___,wa_,wa_,wa_,wa_,wa_,wa_,___,wa_,___
___,wa_,___,___,___,___,___,___,___,go_,wa_,___
___,wa_,wa_,wa_,___,___,___,___,wa_,wa_,wa_,___
___,___,___,___,___,___,___,___,___,___,___,___