lv1_S,,,,,,,,,,,
lk_,no_,op_,no_,,,,,,,,
wa_,wa_,wa_,wa_,wa_,___,___,wa_,wa_,wa_,wa_,wa_
wa_,___,___,___,wa_,___,___,___,___,wa_,___,wa_
wa_,___,wa_,___,wa_,___,wa_,wa_,___,wa_,___,wa_
___,___,wa_,___,wa_,___,sf_,wa_,___,wa_,___,___
wa_,___,wa_,sf_,wa_,wa_,___,wa_,sf_,wa_,___,wa_
wa_,___,wa_,___,___,___,___,wa_,___,___,___,wa_
wa_,wa_,wa_,wa_,wa_,___,___,wa_,wa_,wa_,wa_,wa_
