lv1_S,,,,,,,,,,,
lk_,cl_,no_,no_,,,,,,,,
___,___,___,___,___,___,___,ks_,___,___,___,___
___,___,___,___,___,___,___,___,___,___,___,___
___,___,___,ks_,___,bl_,bl_,___,___,___,___,___
ks_,___,___,___,___,bl_,bl_,___,___,___,___,___
___,___,___,ks_,___,bl_,bl_,___,___,___,___,___
___,ks_,___,___,___,___,___,___,___,___,___,___
___,___,___,___,___,___,___,ks_,___,___,___,___