lv1_S,,,,,,,,,,,										
lk_,op_,op_,op_,,,,,,,,			
___,hc_,hc_,___,___,hc_,hc_,ky_,ky_,___,___,___
___,rs_,cs_,___,rs_,___,___,ls_,mp_,___,ls_,___
___,___,___,bw_,bm_,lp_,fo_,bc_,ra_,___,___,___
___,rs_,___,___,rs_,bb_,bb_,ls_,___,___,ls_,___
___,___,___,___,___,dt_,dt_,___,___,___,___,___
___,rs_,___,dt_,rs_,dt_,dt_,ls_,dt_,___,ls_,___
___,___,___,dt_,dt_,dt_,dt_,dt_,dt_,___,___,___
