lv1_S,,,,,,,,,,,
no_,no_,no_,op_,,,,,,,,
___,___,___,___,___,___,___,___,___,___,___,___
___,___,kD_,___,___,___,___,sf_,___,___,sf_,___
___,___,bl_,bl_,___,___,___,___,bl_,bl_,___,___
___,___,bl_,bl_,___,___,___,___,bl_,bl_,___,___
___,___,bl_,bl_,___,___,___,sf_,bl_,bl_,sf_,___
___,___,sf_,___,___,___,___,___,___,___,___,___
___,___,___,___,___,___,___,___,___,___,___,___
