lv1_S,,,,,,,,,,,
lk_,no_,no_,op_,,,,,,,,
___,___,___,wm_,wm_,___,___,___,___,___,wm_,wm_
___,bl_,___,bl_,___,bl_,bl_,___,bl_,___,bl_,___
___,___,___,___,___,___,___,___,ky_,___,___,___
___,bl_,___,bl_,___,bl_,bl_,___,bl_,___,bl_,___
___,___,___,___,___,___,___,___,___,___,___,wm_
___,bl_,___,bl_,___,bl_,bl_,___,bl_,___,bl_,___
___,___,___,___,___,___,___,___,ky_,___,___,wm_