lv1_S,,,,,,,,,,,
bb_,no_,no_,op_,,,,,,,,
___,___,___,ks_,___,___,___,___,___,___,___,___
___,___,bl_,___,___,___,___,___,___,bl_,ks_,___
___,___,___,___,___,___,ks_,___,ks_,___,___,___
___,___,___,___,___,___,___,___,___,___,cs_,ks_
___,___,___,___,___,___,ks_,___,ks_,___,___,___
___,___,bl_,___,___,___,___,___,___,bl_,ks_,___
___,___,___,___,___,___,___,___,___,___,___,___