lv1_S,,,,,,,,,,,
no_,op_,no_,no_,,,,,,,,
___,___,___,___,___,___,___,___,___,___,___,___
___,ks_,___,___,___,___,___,___,___,___,___,___
___,___,___,ks_,___,___,___,___,___,___,___,___
___,___,___,___,___,___,___,___,___,___,___,___
___,___,___,___,___,___,___,___,___,___,___,___
___,ks_,___,___,___,___,___,___,___,___,___,___
___,___,___,___,___,___,___,___,___,___,___,___
