lv1_S,,,,,,,,,,,
no_,lk_,op_,no_,,,,,,,,
___,___,___,___,___,___,___,bl_,bl_,bl_,bl_,bl_
___,___,___,___,___,___,___,___,___,bl_,bl_,bl_
___,___,___,___,___,___,___,___,___,___,bl_,bl_
___,___,___,___,___,___,___,___,aq_,___,hc_,___
___,___,___,___,___,___,___,___,___,___,bl_,bl_
___,___,___,___,___,___,___,___,___,bl_,bl_,bl_
___,___,___,___,___,___,___,bl_,bl_,bl_,bl_,bl_