lv1_S,,,,,,,,,,,
no_,op_,lk_,cl_,,,,,,,,
___,___,___,sg_,___,___,___,___,___,___,___,___
___,sg_,___,___,___,___,___,___,___,___,sg_,___
___,___,___,___,___,___,___,___,___,___,___,___
___,___,___,___,bj_,___,___,___,___,___,___,___
___,___,___,___,___,___,___,___,___,___,___,___
___,___,___,___,___,___,___,___,___,___,___,___
___,___,___,___,___,___,___,___,___,___,___,___
